xxxxxxxxxxxxxxxxxxxxxx
x x  x     xx   x   xx
x    x   xx x        x
x     o     xx      xx
xxxxx   xxxxx       xx
x        xx    xx    x
x   xxx        xx    x
x                    x
xx      xxxxx   xxxxxx
x    x      x        x
xxxxxx               x
xxx     x xx     x   x
x          x         x
x       xx         xxx
xxxxxxxxxxxxxxxxxxxxxx